#######################################/
#.....................................#/
#.....................................#/
#.....................................#/
#.....................................#/
#....................@................#/
#.....................................#/
#........@............................#/
#..........................@..........#/
#.....................................#/
#...........@.........................#/
#.....................................#/
#.....................................#/
#.....................................#/
#.....................................#/
#.....................................#/
#.....................................#/
#.....................................#/
#.....................................#/
#.....................................#/
#.....................................#/
#.....................................#/
#.....................................#/
#.....................................#/
#.....................................#/
#................X....................#/
#.....................................#/
#.....................................#/
#.....................................#/
#######################################/

